{
  "lines": [
    "##########################",
    "#........................#",
    "#..........ooo...........#",
    "#..........ooo...........#",
    "#..........ooo...........#",
    "#..........ooo...........#",
    "#..........ooo...........#",
    "#..........ooo...........#",
    "#..........ooo...........#",
    "##########################"
  ]
}